####################
##                ##
##                ##
##   #########    ##
##        #       ##
##        #       ##
##        #       ##
###########   ######
##                ##
####################