####################
##P               ##
##      X         ##
##   #########    ##
##      O #       ##
##        #       ##
##        #       ##
###########   ######
##O      X        ##
####################