####################
##                ##
##     O    P     ##
##                ##
##                ##
##   #########    ##
##        #       ##
##        #       ##
##        #       ##
###########   ######
##O      X        ##
####################